NO ./maps/texture1 
SO ./maps/texture2 
WE ./maps/texture3 
EA ./maps/texture4 



F 220,100,0
C 222,30,0


11111111
10010N1
1000001
1000001
1111111