NO ./path_to_the_north_texture
SO ./path_to_the_south_texture
WE ./path_to_the_west_texture
EA ./path_to_the_east_texture



F 220,100,0
C 225,30,0

       1111111111111111111111111111
1010000010000000000000000001
    10101011110001
100010100010000010001
1111101001011101
        100000101000101000001
