NO ./maps/texture1
SO ./maps/texture2
WE ./maps/texture3
EA ./maps/texture4

F 20,20,20
C 200,200,200

111111111111
1    101    11
1     1    1
111111111111
10S000000001
111111111111
11         1
111111111111
