F 0,0,0
C 101,67,33

NO ./maps/texture1
SO ./maps/texture2
WE ./maps/texture3
EA ./maps/texture4

111111111111
100000000011
100000000001
100000000011
10S000000001
111111111111
100000000001
111111111111