F 0,0,0
C 101,67,30

NO ./maps/texture1
SO ./maps/texture2
WE ./maps/texture3
EA ./maps/texture4

11111111111111111111
10000000010000000001
1000N000010000000001
10000000010000000001
10000000010000000001
1111D1111D11111111D1
10000000010000000001
10000D00010000000001
100000000D0000000001
11111111111111111111
