F 200,20,20
C 20,20,20


NO ./maps/texture1
SO ./maps/texture2
WE ./maps/texture3
EA ./maps/texture4

    
11111111111111
10000000000001
111111D1111111
10000000000001
10000000000001
1000000W000001
10000000000001
10000000000001
11111111111111
