F 0,0,0
C 101,67,33

NO ./maps/texture1
SO ./maps/texture2
WE ./maps/texture3
EA ./maps/texture4

111111111111111111111111111111111111111111111111111111111111111111111111111111111111111111111111111111111111111111111111111111111111111111
100000000000000000000000000000000000000000000000000000000000000000000000000000000000000000000000000000000000000000000000000000000000000001
100000000000000000000000000000000000000000000000000000000000000000000000000000000000000000000000000000000000000000000000000000000000000001
100000000000000000000000000000000000000000000000000000000000000000000000000000000000000000000000000000000000000000000000000000000000000001
100000000000000000000000000000000000000000000000000000000000000000000000000000000000000000000000000000000000000000000000000000000000000001
100000000000000000000000000000000000000000000000000000000000000000000000000000000000000000000000000000000000000000000000000000000000000001
100000000000000000000000000000000000000000000000000000000000000000000000000000000000000000000000000000000000000000000000000000000000000001
100000000000000000000000000000000000000000000000000000000000000000000000000000000000000000000000000000000000000000000000000000000000000001
100000000000000000000000000000000000000000000000000000000000000000000000000000000000000000000000000000000000000000000000000000000000000001
1000000001111111111111111111111111111111111111111111111111111111111111111111111111111111111111111111111111111111111111111111111110000000001
1000000001000000000000000000000000000000000000000000000000000000000000000000000000000000000000000000000000000000000000000000000010000000001
1000000001000000000000000000000000000000000000000000000000000000000000000000000000000000000000000000000000000000000000000000000010000000001
1000000001000000000000000000000000000000000000000000000000000000000000000000000000000000000000000000000000000000000000000000000010000000001
1000000001000000000000000000000000000000000000000000000000000000000000000000000000000000000000000000000000000000000000000000000010000000001
1000000001000000000000000000000000000000000000000000000000000000000000000000000000000000000000000000000000000000000000000000000010000000001
100000000D000000000000000000000000000000000000000000000000000000000000000000000000000000000000000000000000000000000000000000000D10000000001
1000000001000000000000000000000000000000000000000000000000000000000000000000000000000000000000000000000000000000000000000000000010000000001
1000000001000000000000000000000000000000000000000000000000000000000000000000000000000000000000000000000000000000000000000000000010000000001
1000000001000000000000000000000000000000000000000000000000000000000000000000000000000000000000000000000000000000000000000000000010000000001
1000000001000000000000000000000000000000000000000000000000000000000000000000000000000000000000000000000000000000000000000000000010000000001
1000000001000000000000000000000000000000000000000000000000000000000000000000000000000000000000000000000000000000000000000000000010000000001
1000000001000000000000000000000000000000000000000000000000000000000000000000000000000000000000000000000000000000000000000000000010000000001
1000000001000000000000000000000000000000000000000000000000000000000000000000000000000000000000000000000000000000000000000000000010000000001
1000000001000000000111111111111111111111111111111111111111111111111111111111111111111111111111111111111111111111111111111100000010000000001
1000000001000000000100000000000000000000000000000000000000000000000000000000000000000000000000000000000000000000000000000100000010000000001
1000000001000000000100000000000000000000000000000000000000000000000000000000000000000000000000000000000000000000000000000100000010000000001
1000000001000000000100000000000000000000000000000000000000000000000000000000000000000000000000000000000000000000000000000100000010000000001
1000000001000000000100000000000000000000000000000000000000000000000000000000000000000000000000000000000000000000000000000100000010000000001
1000000001000000000100000000000000000000000000000000000000000000000000000000000000000000000000000000000000000000000000000100000010000000001
1000000001000000000100000000000000000000000000000000000000000000000000000000000000000000000000000000000000000000000000000100000010000000001
1000000001000000000100000000000000000000000000000000000000000000000000000000000000000000000000000000000000000000000000000100000010000000001
1000000001000000000100000000000000000000000000000000000000000000000000000000000000000000000000000000000000000000000000000100000010000000001
1000000001000000000D00000000000000000000000000000000000000000000000000000000000000000000000000000000000000000000000000000D00000010000000001
1000000001000000000100000000000000000000000000000000000000000000000000000000000000000000000000000000000000000000000000000100000010000000001
1000000001000000000100000000000000000000000000000000000000000000000000000000000000000000000000000000000000000000000000000100000010000000001
1000000001000000000100000000000000000000000000000000000000000000000000000000000000000000000000000000000000000000000000000100000010000000001
1000000001000000000100000000000000000000000000000000000000000000000000000000000000000000000000000000000000000000000000000100000010000000001
1000000001000000000100000000000000000000000000000000000000000000000000000000000000000000000000000000000000000000000000000100000010000000001
1000000001000000000100000000000000000000000000000000000000000000000000000000000000000000000000000000000000000000000000000100000010000000001
10000000010000000001000000000000000000000000000000000000000000000000000000000000000000000000000000000000000000000000000001000000100000000011
100000000100000000010000000011111111111111111111111111111111111111111111111111111111111111111111111111111111111111111000000010000001000000001
100000000100000000010000000010000000000000000000000000000000000000000000000000000000000000000000000000000000000000010000000010000001000000001
100000000100000000010000000010000000000000000000000000000000000000000000000000000000000000000000000000000000000000010000000010000001000000001
100000000100000000010000000010000000000000000000000000000000000000000000000000000000000000000000000000000000000000010000000010000001000000001
100000000100000000010000000010000000000000000000000000000000000000000000000000000000000000000000000000000000000000010000000010000001000000001
100000000100000000010000000010000000000000000000000000000000000000000000000000000000000000000000000000000000000000010000000010000001000000001
100000000100000000010000000010000000000000000000000000000000000000000000000000000000000000000000000000000000000000010000000010000001000000001
100000000100000000010000000010000000000000000000000000000000000000000000000000000000000000000000000000000000000000010000000010000001000000001
100000000100000000010000000010000000000000000000000000000000000000000000000000000000000000000000000000000000000000010000000010000001000000001
100000000100000000010000000010000000000000000000000000000000000000000000000000000000000000000000000000000000000000010000000010000001000000001
10000000010000000001000000001000000000000000000000000000000000000000000000000000000000000000000000000000000000000001000000001000000N000000001
100000000100000000010000000010000000000000000000000000000000000000000000000000000000000000000000000000000000000000010000000010000001000000001
100000000100000000010000000010000000000000000000000000000000000000000000000000000000000000000000000000000000000000010000000010000001000000001
100000000100000000010000000010000000000000000000000000000000000000000000000000000000000000000000000000000000000000010000000010000001000000001
100000000100000000010000000010000000000000000000000000000000000000000000000000000000000000000000000000000000000000010000000010000001000000001
100000000100000000010000000010000000000000000000000000000000000000000000000000000000000000000000000000000000000000010000000010000001000000001
100000000100000000010000000010000000000000000000000000000000000000000000000000000000000000000000000000000000000000010000000010000001000000001
100000000100000000010000000010000000000000000000000000000000000000000000000000000000000000000000000000000000000000010000000010000001000000001
100000000100000000010000000010000000000000000000000000000000000000000000000000000000000000000000000000000000000000010000000010000001000000001
10000000010000000001000000001111111111111111111111111111111111111111111111111111111111111111111111111111111111111111000000001000000D000000001
100000000100000000010000000000000000000000000000000000000000000000000000000000000000000000000000000000000000000000000000000010000001000000001
100000000100000000010000000000000000000000000000000000000000000000000000000000000000000000000000000000000000000000000000000010000001000000001
100000000100000000010000000000000000000000000000000000000000000000000000000000000000000000000000000000000000000000000000000010000001000000001
100000000100000000010000000000000000000000000000000000000000000000000000000000000000000000000000000000000000000000000000000010000001000000001
100000000100000000010000000000000000000000000000000000000000000000000000000000000000000000000000000000000000000000000000000010000001000000001
100000000100000000010000000000000000000000000000000000000000000000000000000000000000000000000000000000000000000000000000000010000001000000001
100000000100000000010000000000000000000000000000000000000000000000000000000000000000000000000000000000000000000000000000000010000001000000001
100000000D00000000010000000000000000000000000000000000000000000000000000000000000000000000000000000000000000000000000000000010000000000000001
100000000100000000010000000000000000000000000000000000000000000000000000000000000000000000000000000000000000000000000000000010000001000000001
100000000100000000010000000000000000000000000000000000000000000000000000000000000000000000000000000000000000000000000000000010000001000000001
100000000100000000010000000000000000000000000000000000000000000000000000000000000000000000000000000000000000000000000000000010000001000000001
100000000100000000010000000000000000000000000000000000000000000000000000000000000000000000000000000000000000000000000000000010000001000000001
100000000100000000010000000000000000000000000000000000000000000000000000000000000000000000000000000000000000000000000000000010000001000000001
100000000100000000010000000000000000000000000000000000000000000000000000000000000000000000000000000000000000000000000000000010000001000000001
100000000100000000010000000000000000000000000000000000000000000000000000000000000000000000000000000000000000000000000000000010000001000000001
100000000100000000010000000000000000000000000000000000000000000000000000000000000000000000000000000000000000000000000000000010000001000000001
100000000111111111111111111111111111111111111111111111111111111111111111111111111111111111111111111111111111111111111111111111111111000000001
100000000000000000000000000000000000000000000000000000000000000000000000000000000000000000000000000000000000000000000000000000000000000000001
100000000000000000000000000000000000000000000000000000000000000000000000000000000000000000000000000000000000000000000000000000000000000000001
100000000000000000000000000000000000000000000000000000000000000000000000000000000000000000000000000000000000000000000000000000000000000000001
100000000000000000000000000000000000000000000000000000000000000000000000000000000000000000000000000000000000000000000000000000000000000000001
100000000000000000000000000000000000000000000000000000000000000000000000000000000000000000000000000000000000000000000000000000000000000000001
100000000000000000000000000000000000000000000000000000000000000000000000000000000000000000000000000000000000000000000000000000000000000000001
100000000000000000000000000000000000000000000000000000000000000000000000000000000000000000000000000000000000000000000000000000000000000000001
100000000000000000000000000000000000000000000000000000000000000000000000000000000000000000000000000000000000000000000000000000000000000000001
111111111111111111111111111111111111111111111111111111111111111111111111111111111111111111111111111111111111111111111111111111111111111111111