F 200,20,20
C 20,20,20


NO ./maps/texture1
SO ./maps/texture2
WE ./maps/texture3
EA ./maps/texture4

    
111111111111111111111111111
100000000000000000000000001
100000000000000000000000001
100000000000000000000000001
110101010101010101010101011
100000000000000000000000001
100000000000000000000000001
100000000000000000000000001
100000000000000000000000001
1000000W0000000000000000001
100000000000000000000000001
100000000000000000000000001
111111111111111111111111111
