F 0,0,0
C 101,67,33

NO ./maps/texture1
SO ./maps/texture2
WE ./maps/texture3
EA ./maps/texture4

11111111111111111111
11001000000000000001
10100100000000000001
10010010000000000001
10001001000000000001
10000100100000000001
100000S0010000000001
10000001001000000001
10000000100100000001
10000000010010000001
10000000001001000001
10000000000100D00001
10000000000010010001
1111111111111111111