F 46,165,62
C 158,249,255


NO ./maps/texture1
SO ./maps/texture2
WE ./maps/texture3
EA ./maps/texture4

    
111111111111111111111111
100000000000000000000001
100000000000000000000001
1DDDDDDDDDD1DDDDDDDDDDD1
100000000000000000000001
100000000000000000000001
100000000000000000000001
100000000000000000000001
100000000000000000000001
100000000000000000000001
100000000000000000000001
10000000000N000000000001
100000000000000000000001
111111111111111111111111