F 200,20,20
C 20,20,20


NO ./maps/texture1
SO ./maps/texture2
WE ./maps/texture3
EA ./maps/texture4

    
11111111111111111111111111111111111111111111111111
100000000000000000000000000000000000000000000001
100000000000000000000000000000000000000000000001
100000000000000000000000000000000000000000000001
110101010101010101010101010101010101010101010101
100000000000000000000000000000000000000000000001
100000000000000000000000000000000000000000000001
100000000000000000000000000000000000000000000001
100000000000000000000000000000000000000000000001
1000000N0000000000000000000000000000000000000001
100000000000000000000000000000000000000000000001
100000000000000000000000000000000000000000000001
11111111111111111111111111111111111111111111111111
