F 0,0,0
C 101,67,30

NO ./maps/texture1
SO ./maps/texture2
WE ./maps/texture3
EA ./maps/texture4

111111111111111111111111111
1000000000E0000000000000001
110101010101101010101010101
1010101010101D1101010101011
100000000000000000000000001
1111D11111D111111D1111D1111
111001111000111100011000111
111101111110111111011110111
111101111000111100011110111
111101111110111111011110111
111101111000111100011110111
111111111111111111111111111
110000000000000000000000011
111110000000000000000011111
111111110000000000011111111
111111111111111111111111111
