F 0,0,0
C 101,67,33

NO ./maps/texture1
SO ./maps/texture2
WE ./maps/texture3
EA ./maps/texture4

11111111111
1ED000000001
111111111111111