F 0,0,0
C 101,67,30

NO ./maps/texture1
SO ./maps/texture2
WE ./maps/texture3
EA ./maps/texture4

111111111111111111111111111111
100000000000001000000000000001
1000N0000000001000000000000001
100000000000001000000000000001
100000000000001000000000000001
100000000000001000000000000001
100000000000001000000000000001
111111111D1111D1111111111111D1
100000000000001000000000000001
100000000000001000000000000001
100000000000001000000000000001
100000000000001000000000000001
10000000000000D000000000000001
111111111111111111111111111111
